B cell	VPREB1
CD103-positive dendritic cell	CD59
Cytotoxic T cell	GZMK
Dendritic cell	FCER1A
Effector memory CD8-positive, alpha-beta T cell	SLC1A7
Erythroid lineage cell	APOC1
Erythroid precursor cell	SHMT2
Exhausted T cell	CD244
Hematopoietic cell	DNTT
Hematopoietic precursor cell	PTPRC
Leukemia stem cell	CD47
Leukemic cell	NOP53
Mature conventional dendritic cell	ITGAE
Monocyte	VCAN
Myeloid cell	CLEC12A
Naive thymus-derived CD8-positive, alpha-beta T cell	H1-0
Neutrophil	RNASE2
Non-classical monocyte	SECISBP2L
Plasmacytoid dendritic cell	IRF7
Pro-T cell	CD7
Progenitor cell	SPINK2
T cell	RPL7A
