ARG1+, TREM2+ regulatory myeloid (mreg) cell	ENSG00000262140.1
Age-associated B cell	CTBP2P4
B cell	HLA-DPA1
CD8-positive, alpha-beta T cell	CD8B
Dendritic cell	HLA-DQB1
Effector memory CD8-positive, alpha-beta T cell	GNLY
Erythrocyte	EMC3
Erythroid lineage cell	GATA1
Hematopoietic cell	RPL3
Leukemia stem cell	JUNB
Leukemic cell	RPL39
Mesenchymal stem cell	RPL10
Monocyte	VCAN
Naive T cell	PTPRC
Naive thymus-derived CD8-positive, alpha-beta T cell	TCF7
Natural killer cell	KLRD1
Neutrophil	RPS23
Plasma cell	HERPUD1
Plasmacytoid dendritic cell	GZMB
Pro-T cell	CD7
Progenitor cell	SPINK2
T cell	JUNB
