ARG1+, TREM2+ regulatory myeloid (mreg) cell	MALAT1
Alternatively activated macrophage	CCL2
B cell	MALAT1
Bone marrow macrophage	TRIM8
CD103-positive dendritic cell	FAU
Dendritic cell, human	SIRPA
Effector memory CD8-positive, alpha-beta T cell	LAT
Erythrocyte	MALAT1
Erythroid lineage cell	TFRC
Erythroid precursor cell	SHMT2
Fibroblast	RPL41
Hematopoietic cell	THY1
Leukemia stem cell	CD47
Leukemic cell	TXN
Macrophage dendritic cell progenitor	AXL
Mature conventional dendritic cell	ITGAE
Mesenchymal stem cell	ITGB1
Monocyte	VCAN
Naive B cell	TCL1A
Osteoblast	ALPL
Plasma cell	SDC1
Plasmablast	XBP1
Plasmacytoid dendritic cell	NRP1
Stromal cell of bone marrow	LAMC2
T cell	CD4
